Stage 1
#####
#OoP#
#####
---
Stage 2
  #######  
###  O  ###
#    o    #
#  OoPoO  #
#    o    #
###  O  ###
  #######    
---
Stage 3
  #### 
###  # 
#P Oo##
#   o #
# #O  #
#     #
#######
---
Stage 4
 ###### 
##    ##
# OO   #
# # ooo#
#   #PO#
########
---
Stage 5
######  
#P   ## 
# Oo0  #
# #oO  #
#      #
########